..........bb.
bbbbbbbbbbbb.
.wbwbbbbbbb..
.bwbbbbbbbb..
.wbwwwwwwww..
.............
.............
......c......
.###.........
.............
.............
.....###.....
....@#F#.....
2 4 1 3