.............
.............
..####.#...#.
..#..#..#.#..
..###....#...
..#......#...
..#......#...
..#......#...
...........ww
...........ww
...........ww
ccccc###c..bb
....@#F#ccccc
1 2 3 4